,Unnamed: 0,Items,Cost(£),Expenses(£),Revenue(£)
0,1,Weapons,35000,30000,5000
1,2,Helicopter(Black Hawk),12000000,3000000,9000000
2,3,Helicopter(shadouk),30000000,25000000,5000000
3,4,Helicopter(Apacci),23000000,20000000,3000000
4,5,Cameras,200000,150000,50000
5,6,Night Vision,32000,21000,11000
6,7,Uniform,570000,450000,120000
7,8,Planes(F1),2300000000,1600000000,700000000
8,9,Planes(typoon 31),50000000,20000000,30000000
9,10,Equipment,125000,100000,25000
